151 151 151 151 151 151 151 151 151 151 151 151 151 151 151 151 151 151 151 151 151 151 151 151 151 151 151 151 151 151 151 151 151 151 151 151 151 151 151 151 151 151 151 151 151 151 151 151 151 151 
151 0 0 0 0 0 0 0 0 0 0 0 0 0 0 0 0 0 0 0 0 0 0 0 0 0 0 0 0 0 0 0 0 0 0 0 0 0 0 0 0 0 0 0 0 0 0 0 0 151 
151 0 0 0 0 0 0 0 0 0 0 0 0 0 0 0 0 0 0 0 0 0 0 0 0 0 0 0 0 0 0 0 0 0 0 0 0 0 0 0 0 0 0 0 0 0 0 0 0 151 
151 0 0 0 0 0 0 0 0 0 0 0 0 0 0 0 0 0 0 0 0 0 0 0 0 0 0 0 0 0 0 0 0 0 0 0 0 0 0 0 0 0 0 0 0 0 0 0 0 151 
151 0 0 0 0 0 0 0 0 0 0 0 0 0 0 0 0 0 0 0 0 0 0 0 0 0 0 0 0 0 0 0 0 0 0 0 0 0 0 0 0 0 0 0 0 0 0 0 0 151 
151 0 0 0 0 0 0 0 0 0 0 0 0 9 0 0 0 0 0 0 0 0 0 0 0 0 0 0 0 0 0 0 0 0 0 0 0 0 0 0 0 0 0 0 0 0 0 0 0 151 
151 0 0 0 0 0 0 0 0 0 0 0 9 9 9 9 9 9 9 9 9 9 9 9 9 9 9 9 9 9 9 9 9 9 0 0 0 0 0 0 0 0 0 0 0 0 0 0 0 151 
151 0 0 0 0 0 0 0 0 0 0 9 9 9 9 9 9 9 9 9 9 9 9 9 9 9 9 9 9 9 9 9 9 9 0 0 0 0 0 0 0 0 0 0 0 0 0 0 0 151 
151 0 0 0 0 0 0 0 0 9 9 9 9 9 9 9 9 9 9 9 9 9 9 9 9 9 9 9 9 9 9 9 9 9 9 9 0 0 0 0 0 0 0 0 0 0 0 0 0 151 
151 0 0 9 9 9 9 9 9 9 9 9 9 9 9 9 24 17 17 17 17 17 17 17 17 17 17 17 17 17 17 17 17 26 9 9 0 0 0 0 0 0 0 0 0 0 0 0 0 151 
151 0 0 9 9 9 9 9 9 9 9 9 9 9 9 9 10 144 145 145 145 145 145 145 145 145 145 145 145 145 145 145 146 8 9 9 0 0 0 0 0 0 0 0 0 0 0 0 0 151 
151 0 0 9 9 9 9 9 9 9 9 9 9 9 9 9 10 152 0 1 1 1 1 1 1 1 1 1 1 1 1 2 152 8 9 9 0 0 0 0 0 0 0 0 0 0 0 0 0 151 
151 0 0 9 9 9 9 9 9 9 9 9 9 9 9 9 10 152 8 9 191 9 9 9 9 9 9 9 9 9 9 10 152 8 9 9 9 0 0 0 0 0 0 0 0 0 0 0 0 151 
151 0 0 9 9 9 9 9 9 9 9 9 9 9 9 9 10 152 8 9 9 9 9 9 9 9 9 9 9 191 9 10 152 8 9 9 9 9 0 0 0 0 0 0 0 0 0 0 0 151 
151 0 0 9 9 9 9 9 9 9 9 24 17 17 17 17 18 152 16 17 17 17 17 17 17 26 9 9 9 9 9 10 152 8 9 9 9 9 0 0 0 0 0 0 0 0 0 0 0 151 
151 0 0 9 9 9 9 9 9 9 9 10 144 161 161 161 161 173 161 145 145 145 145 145 146 8 9 9 9 9 9 10 152 8 9 9 9 9 9 0 0 0 0 0 0 0 0 0 0 151 
151 0 0 9 9 9 9 9 9 9 9 10 152 0 1 1 1 1 1 1 1 1 1 2 163 8 9 9 9 9 9 10 152 8 9 9 9 9 9 0 0 0 0 0 0 0 0 0 0 151 
151 0 9 9 9 9 9 9 9 9 9 10 152 8 191 9 9 9 9 191 9 9 9 10 9 16 17 17 17 17 17 18 152 8 9 9 9 9 9 9 9 9 9 9 9 9 9 9 9 151 
151 9 9 9 9 9 9 9 9 9 9 10 152 8 9 9 9 9 9 9 9 9 9 10 144 161 161 161 161 145 145 161 162 8 9 9 9 9 9 9 9 9 9 9 9 9 9 9 9 151 
151 9 9 9 9 9 9 9 9 9 9 10 152 8 9 9 9 9 9 9 9 9 9 10 152 0 1 1 1 1 1 1 1 42 9 9 9 9 9 9 9 9 9 9 9 9 9 9 9 151 
151 9 9 9 9 9 9 9 9 9 9 10 152 16 17 17 17 17 17 17 17 9 9 10 152 8 9 9 9 9 9 9 9 9 9 9 9 9 9 9 9 9 9 9 9 9 9 9 9 151 
151 9 9 9 9 9 9 9 9 9 9 10 160 161 161 161 161 161 161 161 146 8 9 10 152 8 9 9 9 9 9 9 9 9 9 9 9 9 9 9 9 9 9 9 9 9 9 9 9 151 
151 9 9 9 9 9 9 9 9 9 9 40 1 1 1 1 1 1 1 2 152 8 9 10 152 8 9 9 9 9 9 9 9 9 9 9 9 9 9 9 9 9 9 9 9 9 9 9 9 151 
151 9 9 9 9 9 9 9 9 9 9 9 9 24 17 17 17 17 17 18 152 16 25 18 152 16 17 17 26 9 9 9 9 9 9 9 9 9 9 9 9 9 9 9 9 9 9 9 9 151 
151 9 9 9 9 9 9 9 9 9 9 9 9 10 144 145 145 145 145 145 173 150 35 148 173 145 145 146 16 17 17 26 9 9 9 9 9 9 9 9 9 9 9 9 9 9 9 9 9 151 
151 9 9 9 9 9 9 9 9 9 9 9 9 10 152 0 1 1 1 1 1 1 41 1 1 1 2 160 161 161 146 8 9 9 9 9 9 9 9 9 9 9 9 9 9 9 9 9 9 151 
151 9 9 9 9 9 9 9 9 9 9 9 9 10 152 8 9 191 9 9 9 9 9 9 9 9 40 1 1 2 152 8 9 9 9 9 9 9 9 9 9 9 9 9 9 9 9 9 0 151 
151 9 9 9 9 9 9 9 9 9 9 9 9 10 152 8 9 9 9 9 9 9 9 9 9 9 9 9 191 10 152 8 9 9 9 9 9 9 9 9 9 9 9 9 9 9 9 9 0 151 
151 9 9 9 9 9 9 9 9 9 9 9 9 10 152 16 17 17 17 17 17 17 17 17 17 17 17 17 17 18 155 8 9 9 9 9 9 9 9 9 9 9 9 9 9 9 9 9 0 151 
151 0 9 9 9 9 9 9 9 9 9 9 9 10 160 145 145 145 145 145 145 145 145 145 161 161 161 161 161 161 162 8 9 9 9 9 9 9 9 9 9 9 9 9 9 9 9 9 0 151 
151 0 0 0 9 9 9 9 9 9 9 9 9 40 1 1 1 1 1 1 1 1 1 1 1 1 1 1 1 1 1 42 9 9 9 9 9 9 9 9 9 9 9 9 9 9 9 9 0 151 
151 0 0 0 9 9 9 9 9 9 9 9 9 9 9 9 9 9 9 9 9 9 9 9 9 9 9 9 9 9 9 9 9 9 9 9 9 9 9 9 9 9 9 9 9 9 9 9 0 151 
151 0 0 0 0 0 9 9 9 9 9 9 9 9 9 9 9 9 9 9 9 9 9 9 9 9 9 9 9 9 9 9 9 9 9 9 9 9 9 9 9 9 9 9 9 9 9 9 0 151 
151 0 0 0 0 0 0 9 9 9 9 9 9 9 9 9 9 9 9 9 9 9 9 9 9 9 9 9 9 9 9 9 9 9 9 9 9 9 9 9 9 9 9 9 0 0 0 0 0 151 
151 0 0 0 0 0 0 0 9 9 9 9 9 9 9 9 9 9 9 9 9 9 9 9 9 9 9 9 9 9 9 9 9 9 9 9 9 9 9 9 9 9 9 9 0 0 0 0 0 151 
151 0 0 0 0 0 0 0 0 9 9 9 9 9 9 9 9 9 9 9 9 9 9 9 9 9 0 0 9 9 9 9 9 9 9 9 9 9 9 9 9 9 9 9 0 0 0 0 0 151 
151 0 0 0 0 0 0 0 0 0 0 0 0 0 0 0 0 0 0 0 0 0 0 0 0 0 0 0 9 9 9 9 9 9 9 9 9 9 9 9 9 9 9 9 0 0 0 0 0 151 
151 0 0 0 0 0 0 0 0 0 0 0 0 0 0 0 0 0 0 0 0 0 0 0 0 0 0 0 9 9 9 9 9 9 9 9 9 9 9 9 9 9 9 9 0 0 0 0 0 151 
151 0 0 0 0 0 0 0 0 0 0 0 0 0 0 0 0 0 0 0 0 0 0 0 0 0 0 0 9 9 9 9 9 9 9 9 9 9 9 9 9 9 9 9 0 0 0 0 0 151 
151 0 0 0 0 0 0 0 0 0 0 0 0 0 0 0 0 0 0 0 0 0 0 0 0 0 0 0 9 9 9 9 9 9 9 9 9 9 9 9 9 9 9 9 0 0 0 0 0 151 
151 0 0 0 0 0 0 0 0 0 0 0 0 0 0 0 0 0 0 0 0 0 0 0 0 0 0 0 9 9 9 9 9 9 9 9 9 9 9 9 9 9 9 9 0 0 0 0 0 151 
151 0 0 0 0 0 0 0 0 0 0 0 0 0 0 0 0 0 0 0 0 0 0 0 0 0 0 0 0 0 0 0 0 0 0 0 0 0 0 0 0 0 0 0 0 0 0 0 0 151 
151 0 0 0 0 0 0 0 0 0 0 0 0 0 0 0 0 0 0 0 0 0 0 0 0 0 0 0 0 0 0 0 0 0 0 0 0 0 0 0 0 0 0 0 0 0 9 9 0 151 
151 0 0 0 0 0 0 0 0 0 0 0 0 0 0 0 0 0 0 0 0 0 0 0 0 0 0 0 0 0 0 0 0 0 0 0 0 0 0 0 0 0 0 0 0 9 9 9 0 151 
151 0 0 0 0 0 0 0 0 0 0 0 0 0 0 0 0 0 0 0 0 0 0 0 0 0 0 0 0 0 0 0 0 0 0 0 0 0 0 0 0 0 0 0 9 9 9 9 0 151 
151 0 0 0 0 0 0 0 0 0 0 0 0 0 0 0 0 0 0 0 0 0 0 0 0 0 0 0 0 0 0 0 0 0 0 0 0 0 0 0 0 0 0 0 9 9 9 9 0 151 
151 0 0 0 0 0 0 0 0 0 0 0 0 0 0 0 0 0 0 0 0 0 0 0 0 0 0 0 0 0 0 0 0 0 0 0 0 0 0 0 0 0 0 9 9 9 0 0 0 151 
151 0 0 0 0 0 0 0 0 0 0 0 0 0 0 0 0 0 0 0 0 0 0 0 0 0 0 0 0 0 0 0 0 0 0 0 0 0 0 0 0 0 9 9 9 9 9 0 0 151 
151 0 0 0 0 0 0 0 0 0 0 0 0 0 0 0 0 0 0 0 0 0 0 0 0 0 0 0 0 0 0 0 0 0 0 0 0 0 0 0 0 9 9 9 9 9 9 9 9 151 
151 151 151 151 151 151 151 151 151 151 151 151 151 151 151 151 151 151 151 151 151 151 151 151 151 151 151 151 151 151 151 151 151 151 151 151 151 151 151 151 151 151 151 151 151 151 151 151 151 151 
